37 37
2 2 2 2 2 2 2 2 2 4 4 4 4 4 4 4 4 4 4 4 4 6 6 6 6 6 6 6 6 6 6 6 6 6 6 6 6
2 2 x 0 0 0 0 0 2 4 0 0 0 0 0 0 0 0 0 0 4 6 0 0 0 0 0 0 0 0 0 0 0 0 0 0 7
2 2 0 0 0 0 0 0 2 4 0 0 0 0 0 0 0 0 0 0 4 6 0 0 0 0 0 0 0 0 0 0 0 0 0 0 7
2 2 0 0 2 2 2 2 2 4 0 0 4 4 0 0 4 4 4 4 4 6 6 6 6 6 0 0 6 6 6 6 6 6 0 0 7
3 0 0 0 3 3 3 3 3 3 0 0 3 5 0 0 5 5 5 5 4 6 6 6 6 6 0 0 6 7 7 7 7 7 0 0 7
3 0 0 0 0 0 0 0 0 0 0 0 3 5 0 0 0 0 0 0 5 6 0 0 0 0 0 0 6 7 0 0 0 0 0 0 7
3 0 0 0 0 0 0 0 0 0 0 0 3 5 0 0 0 0 0 0 5 6 0 0 0 0 0 0 6 7 0 0 0 0 0 0 7
3 3 3 3 3 3 3 3 3 3 3 3 3 5 5 5 5 5 0 0 5 6 0 0 6 6 6 6 6 7 7 7 7 7 0 0 7
2 2 2 2 2 2 2 2 2 2 2 2 2 2 2 2 2 5 0 0 5 6 0 0 6 7 7 7 7 7 7 7 7 7 0 0 7
2 2 0 0 0 0 0 0 0 0 0 0 0 0 0 0 2 5 0 0 0 0 0 0 6 8 0 0 0 0 0 0 0 0 0 0 8
2 2 0 0 0 0 0 0 0 0 0 0 0 0 0 0 2 5 0 11 0 0 0 0 6 8 0 0 0 0 0 0 0 0 0 0 8
2 2 0 0 2 2 2 2 2 2 2 2 2 2 0 0 2 6 0 0 6 6 6 6 6 8 0 0 8 8 8 8 8 8 0 0 8
2 2 0 0 2 2 2 2 2 2 2 2 2 2 0 0 2 2 2 2 10 10 10 10 10 9 0 0 9 9 9 9 9 9 0 0 9
2 2 0 0 0 0 0 0 2 2 0 0 2 2 0 0 0 0 0 0 2 10 0 0 0 0 0 0 0 0 0 0 9 9 0 0 9
2 2 0 0 0 0 0 0 2 2 0 0 2 2 0 0 0 0 0 0 2 10 0 0 0 0 0 0 0 0 0 0 9 9 0 0 9
2 2 0 0 2 2 0 0 2 2 0 0 2 2 2 2 2 2 0 0 2 10 0 0 2 2 2 2 2 2 0 0 9 9 0 0 9
2 2 0 0 2 2 0 0 2 2 0 0 2 2 2 2 2 2 0 0 2 10 0 0 0 2 2 2 2 2 0 0 9 9 0 0 9
2 2 0 0 2 2 0 0 2 2 0 0 0 0 0 0 2 2 0 0 0 0 0 11 0 0 0 0 0 0 0 0 9 9 0 0 9
2 2 0 0 2 2 0 0 2 2 0 0 0 0 0 0 2 2 0 0 0 0 0 0 0 0 0 0 0 0 0 0 9 9 0 0 9
2 2 2 2 2 2 0 0 2 2 2 2 2 2 0 0 2 2 2 2 2 2 2 2 2 2 2 2 2 2 2 2 2 2 2 2 2
2 2 2 2 2 2 0 0 2 2 2 2 2 2 0 0 2 2 2 2 2 2 2 2 2 2 2 2 2 2 2 2 2 2 2 2 2
2 2 0 2 0 0 0 0 2 2 0 0 0 0 0 0 0 0 0 0 0 0 0 0 0 0 0 0 2 2 0 0 0 0 0 0 2
2 2 0 0 0 0 0 0 2 2 0 0 0 0 0 0 0 0 0 0 0 0 0 0 0 0 0 0 2 2 0 0 0 0 0 0 2
2 2 0 0 2 2 0 0 2 2 0 0 2 2 2 2 2 2 0 0 2 2 0 0 2 2 2 2 2 2 2 2 0 0 2 2 2
2 2 0 0 2 2 0 0 2 2 0 0 2 2 2 2 2 2 0 0 2 2 0 0 2 2 2 2 2 2 2 2 0 0 2 2 2
2 2 0 0 2 2 0 0 2 2 0 0 2 2 0 0 0 0 0 0 2 2 0 0 0 0 0 0 0 0 0 0 0 0 0 0 2
2 2 0 0 2 2 0 0 2 2 0 0 2 2 0 0 0 0 0 0 2 2 0 0 0 0 0 0 0 0 0 0 0 0 0 0 2
2 2 0 0 2 2 2 2 2 2 0 0 2 2 2 2 2 2 2 2 2 2 2 2 2 2 2 2 2 2 2 2 2 2 0 0 2
2 2 0 0 2 2 2 2 2 2 0 0 2 2 2 2 2 2 2 2 2 2 2 2 2 2 2 2 2 2 2 2 2 2 0 0 2
2 2 0 0 0 0 0 0 0 0 0 0 2 2 0 0 0 0 0 0 0 0 0 0 0 0 0 0 2 2 0 0 0 0 0 0 2
2 2 0 0 0 0 0 0 0 0 0 0 2 2 0 0 0 0 0 0 0 0 0 0 0 0 0 0 2 2 0 0 0 0 0 0 2
2 2 2 2 2 2 0 0 2 2 2 2 2 2 0 0 2 2 2 2 2 2 0 0 2 2 2 2 2 2 2 2 2 2 0 0 2
2 2 2 2 2 2 0 0 2 2 2 2 2 2 0 0 2 2 2 2 2 2 0 0 2 2 2 2 2 2 2 2 2 2 0 0 2
2 0 0 0 0 0 0 0 2 2 0 0 0 0 0 0 2 2 0 0 0 0 0 0 0 0 0 0 0 0 0 0 0 0 0 0 2
2 0 0 0 0 0 0 0 2 2 0 0 0 0 0 0 2 2 0 0 0 0 0 0 0 0 0 0 0 0 0 0 0 0 0 0 2
2 2 2 2 2 2 2 2 2 2 2 2 2 2 0 0 2 2 2 2 2 2 2 2 2 2 2 2 2 2 2 2 2 2 2 2 2
2 2 2 2 2 2 2 2 2 2 2 2 2 2 2 2 2 2 2 2 2 2 2 2 2 2 2 2 2 2 2 2 2 2 2 2 2
